++++++++++++++++++++++++++++++++
+G                             +
++                             +
++++++++++++++++++++++++++++   +
++                             +
++                             +
++                             +
++                             +
+  + +++++++++++++++++++++++++ +
+                              +
+                              +
+                              +
+                              +
++++++++++++++++++++           +
+                              +
+                              +
+     ++++++++++++++++++++++++++
+                              +
+                              +
+                              +
+ ++++++++   +++++++++++   +++++
+                              +
+                              +
+                             S+
++++++++++++++++++++++++++++++++