+++++++G++++++++
+     + +      +
+     + +++++  +
+ +++ +     +  +
+ + + ++++  +  +
+ +         +  +
+++ ++++++++   +
+      +       +
+      + +++++++
+ +++  +       +
+ + +  +++++++ +
+   +    +   + +
+++++  + + + + +
+   +  + + + + +
+ +++  +++ + + +
+          +   +
++++++++++S+++++